rows = 9
cols = 19
WWWWWWWWWWW
WFFFFFFFMFW
WFFFFFFFFFW
WFFFFFFFFFW
WFFFFFFFFFW
WFFFWFWFFFW
WFFFWFWFFFW
WFFFWLWFFFW
WWWWWWWWWWW