rows = 20
cols = 20
     W
    WWW
   WFFFW
  WFFFFFW
 WFFFFFFFW 
WFFFFFFFFFW 
WFFFFFFFFFW
WFFFFFFFFFW
WFFFFFFFFFW
WFFFFFFFFFW
WFFFFFFFFFW
WFFFFLFFFFW
WFFFFFFFFFW
WWWWWWWWWWW