rows = 9
cols = 19
WWWWWWWWWWW
WFFFFFFFFFW
WFFFFFFFFFW
WFFFFFFFFFW
WFFFFFFFFFW
WFFFWFWFFFW
WFFFWMWFFFW
WFFFWLWFFFW
WWWWWWWWWWW