rows = 13
cols = 13
WWWWWWWWWWWWW
WFFFFFFFFFFFW
WFFFFFFFFFFFW
WFFFFFFFFFFFW
WFFWWWWWWWWFW
WFFWWWWWWWWFW
WFFWWWWWWWWFW
WFFWWWWWWWWFW
WFFFFFFFFFFFW
WFFFFFFFFFFFW
WFFFFFFFFFFFW
WFFFFFFFFFFFW
WWWWWWWWWWWWW