rows = 13
cols = 19
WWWWWWWWWWW
WFFFFFFFFFW
WFFFFFFFFFW
WFFFFFFFFFW
WFWWWWWWWFW
WFWWWWWWWFW
WFWWWWWWWFW
WFWWWWWWWFW
WFFFFFFFFFW
WFFFFFFFFFW
WFFFFLFFFFW
WFFFFFFFFFW
WWWWWWWWWWW